111111111111111111111111111111111111111111111111111111111111
100000000001111111111111111111100000000001111111111111111111
100000000001111111111111111111100000000001111111111111111111
100000000001111111111111111111100000000001111111111111111111
100000000001111111111111111111100000000001111111111111111111
1000000P00011111111111111111111000000P0001111111111111111111
100000000001111111111111111111100000000001111111111111111111
100000000001111111111111111111100000000001111111111111111111
100000000001111111111111111111100000000001111111111111111111
100000000001111111111111111111100000000001111111111111111111
100000000001111111111111111111100000000001111111111111111111
111111111111111111111111111111111111111111111111111111111111
111111111111111111111111111111111111111111111111111111111111
100000000001111111111111111111100000000001111111111111111111
100000000001111111111111111111100000000001111111111111111111
100000000001111111111111111111100000000001111111111111111111
100000000001111111111111111111100000000001111111111111111111
1000000P00011111111111111111111000000P0001111111111111111111
100000000001111111111111111111100000000001111111111111111111
100000000001111111111111111111100000000001111111111111111111
100000000001111111111111111111100000000001111111111111111111
100000000001111111111111111111100000000001111111111111111111
100000000001111111111111111111100000000001111111111111111111
111111111111111111111111111111111111111111111111111111111111
111111111111111111111111111111111111111111111111111111111111
100000000001111111111111111111100000000001111111111111111111
100000000001111111111111111111100000000001111111111111111111
100000000001111111111111111111100000000001111111111111111111
100000000001111111111111111111100000000001111111111111111111
1000000P00011111111111111111111000000P0001111111111111111111
100000000001111111111111111111100000000001111111111111111111
100000000001111111111111111111100000000001111111111111111111
100000000001111111111111111111100000000001111111111111111111
100000000001111111111111111111100000000001111111111111111111