1111111111111111111111111111111111111111111111111111111111111
1000000000011111111111111111111000000000011111111111111111111
1000000000011111111111111111111000000000011111111111111111111
1000000000011111111111111111111000000000011111111111111111111
1000000000011111111111111111111000000000011111111111111111111
1000000P00011111111111111111111000000P00011111111111111111111
1000000000011111111111111111111000000000011111111111111111111
1000000000011111111111111111111000000000011111111111111111111
1000000000011111111111111111111000000000011111111111111111111
1000000000011111111111111111111000000000011111111111111111111
1000000000011111111111111111111000000000011111111111111111111
1111111111111111111111111111111111111111111111111111111111111
