111111111111
10000000C001
1000P0000001
100000C00001
1CC0000P0001
111111111111