111111111111
100000000001
100000000001
100000000E01
1P0000000001
111111111111