1111111
1P00C11
101C101
101C1E1
1111111
