111111111111
10000000C001
100000000001
100000C00001
1CC000000001
111111111111