1111111
1P00C01
1011101
101C1E1
1111111
