111111111111
100000000011
101C10100011
1111111000E1
100000000001
10P000000001
100010011001
111000011001
111000000001
111111111111