1111111
1P00101
101C1E1
1000001
1000001
1111111
