1111111
1P00C01
101C1E1
1000001
1000001
1111111
