111111111111111111111111111111111111111111111111111111111111
100000000001111111111111111111100000000001111111111111111111
100000000001111111111111111111100000000001111111111111111111
100000000001111111111111111111100000000001111111111111111111
100000000001111111111111111111100000000001111111111111111111
1000000000011111111111111111111000000P0001111111111111111111
1000000C0000000000000000000000000000000001111111111111111111
100000000001111111111111111111100000000001111111111111111111
100000000001111111111111111111100000000001111111111111111111
100000000001111111111111111111100000000001111111111111111111
100000000001111111111111111111100000000001111111111111111111
111101111111111111111111111111100000000001111111111111111111
111101111111111111111111111111100000000001111111111111111111
100000000001111111111111111111100000000001111111111111111111
100000000001111111111111111111100000000001111111111111111111
100000000000000000000000000000000000000001111111111111111111
100000000001111111111111111111100000000001111111111111111111
100000000001111111111111111111100000000001111111111111111111
1000000E0001111111111111111111100000000001111111111111111111
100000000001111111111111111111100000000001111111111111111111
100000000001111111111111111111100000000001111111111111111111
100000000001111111111111111111100000000001111111111111111111
100000000001111111111111111111100000000001111111111111111111
111111111111111111111111111111111110111111111111111111111111
100000000001111111111111111111100000000001111111111111111111
100000000001111111111111111111100000000001111111111111111111
100000000001111111111111111111100000000001111111111111111111
100000000000000000000000000000000000000001111111111111111111
100000000001111111111111111111100000000001111111111111111111
100000000001111111111111111111100000000001111111111111111111
100000000001111111111111111111100000000001111111111111111111
111111111111111111111111111111111111111111111111111111111111