11111111111111111111
10001010100001000001
10110000000100100101
10100000010001010001
100000000C0000000011
11000000100001100001
1P000001101000000001
10000001010101011001
10000000000101100011
10100001100100000101
10000100000000100011
10001010010000001001
10001000100100010E01
11100000000111000001
11111111111111111111