1111111111111111111111111111111111
1E0000000001110C010001000000000001
1110011100111100111001000110010111
1110011100111100111001000110010111
1110010100100000111001001100010111
1010011010101010001001100000010111
1P001111C00C0000000000000000000C11
1111111111111111111111111111111111