111111111111111111111111111111111111
101000000101011000110100000100001001
111010111100000000001001010100010001
100101011101010000100110000000010011
111010000101011000000000000010100101
100000001000010111101000010000011101
10010000100011100C000000000010001001
100101000100100010111000001001010011
110000000101110010001101000001000011
100011010011001101011000100000000101
1P0000110000011001010011001101011001
110100000110000001010101000100100101
100000010100101000000000100110011101
110001001000100100010101010111100001
100001010100001011010000011010101001
111000000011110110000011100101001101
101001010010111001000000000001111001
101010011100010000010110100011001001
101001010000000110110000010110010011
100110010000000001100101000000000E01
111101110000010011000100001001001001
111111111111111111111111111111111111