1111111111111111111111111111111111
110000000001110C010001000000000001
1110011100111100111001000110010111
1110011100111100111001000110010111
1110010100000000111001001100010111
1010011010101010001001100000010111
1P001111C01C1000000E00000000000C11
1111111111111111111111111111111111