111111111111
1P00C0000001
101C10100001
111111100001
100000000001
10000E000001
100C00011001
111000011001
111000000001
111111111111