111111111111
1P0000000001
101C10100011
111111100001
100000E00001
10000100C001
100C00011001
111000011001
111000000001
111111111111