111111111111
1P0000000011
101C10100011
1111111000E1
100000000001
100000000001
100010011001
111000011001
111000000001
111111111111