111111111111
1P00000000E1
101C10100011
111111100001
100000000001
100000000001
100010011001
111000011001
111000000001
111111111111