11111111111111111
10000000001111111
101C1010001111111
1111111000E111111
11111110000110C11
10P0010C000110011
10001001100000111
11100001100111111
11100000000111111
11111111111111111