11111111111111111
10000000001100001
101C1010001000011
1111111000E100101
10000000000101001
1WWWWT00000000001
1WW11W01W0P0WW1W1
1W101W011001W[WW1
1WWWWW000001WWW11
11111111111111111